10 10 10 11 22 0 0 0 0 0 0 0 0 0 0 0 0 0 0 0 0 0 0 0 0 0 0 0 0 0 0 0 0 0 0 0 0 0 0 0 0 0 0 0 0 0 0 0 0 0
10 11 10 10 22 1 1 1 1 1 1 1 1 1 1 1 1 1 1 1 1 1 1 1 1 1 1 1 1 1 1 1 1 1 1 1 1 1 1 1 1 1 1 1 1 1 1 1 1 0
10 10 10 10 22 3 3 3 3 3 3 3 3 3 3 3 3 3 3 3 3 3 3 3 3 3 3 3 3 3 3 3 3 3 3 3 3 3 3 3 3 3 3 3 3 3 3 3 1 0
10 10 10 10 22 1 1 1 1 1 1 1 1 1 1 1 1 1 1 1 1 1 1 1 1 1 1 1 1 1 4 4 1 1 1 1 1 1 1 1 1 1 1 1 1 1 1 3 1 0
10 10 10 30 23 1 1 1 5 5 5 5 5 5 5 5 5 5 1 1 1 1 1 1 1 1 1 1 1 1 4 1 1 1 1 0 0 0 0 0 0 0 0 0 0 0 1 3 1 0
10 10 30 23 1 1 6 5 5 2 2 2 2 2 2 2 2 5 1 1 1 1 1 1 1 1 1 1 1 1 1 1 1 1 1 0 3 3 3 3 3 3 3 3 3 0 1 3 1 0
10 30 23 1 1 5 5 5 5 2 2 2 2 2 2 2 2 5 5 1 1 1 1 1 4 1 1 1 1 1 1 1 1 1 1 0 3 3 3 3 3 3 3 3 3 0 1 3 1 0
30 23 3 1 5 5 5 5 5 2 2 2 2 2 2 2 2 5 5 5 1 1 1 1 1 1 1 1 1 1 1 1 1 1 1 0 3 3 3 3 3 3 3 3 3 0 1 3 1 0
0 1 3 1 6 5 5 5 5 2 2 2 2 2 2 2 2 5 5 5 5 1 1 1 1 1 1 1 1 1 1 4 1 1 1 0 3 3 3 3 3 3 3 3 3 0 1 3 1 0
0 1 3 1 1 5 5 5 5 2 2 2 2 2 2 2 2 5 6 5 5 1 1 4 1 1 1 4 1 1 1 1 1 1 1 0 3 3 3 3 3 3 3 3 3 0 1 3 1 0
0 1 3 1 1 1 6 5 5 2 2 2 2 2 2 2 2 5 5 5 1 1 1 1 1 1 1 1 1 1 1 1 1 1 1 0 3 3 3 3 3 3 3 3 3 0 1 3 1 0
0 1 3 1 1 1 1 1 5 2 2 2 2 2 2 2 2 5 5 1 1 1 1 1 1 1 1 1 1 1 1 1 1 1 1 0 0 0 0 0 3 0 0 0 0 0 1 3 1 0
0 1 3 1 1 1 1 1 5 5 5 5 5 5 5 5 5 5 1 1 3 3 3 3 3 3 3 3 3 3 3 3 1 1 1 1 1 1 1 1 3 1 1 1 1 1 1 3 1 0
0 1 3 1 1 1 1 1 1 1 1 1 1 1 1 1 1 1 3 3 3 1 1 1 1 1 1 1 1 1 1 3 1 1 1 1 1 1 1 1 3 1 4 1 1 4 1 3 1 0
0 1 3 1 1 1 1 1 1 1 1 1 1 1 1 3 3 3 3 1 1 1 1 1 1 1 1 1 1 1 1 3 3 3 3 3 3 3 3 3 3 3 3 3 3 3 3 3 1 0
0 1 3 1 4 1 1 1 1 1 1 1 1 1 1 3 1 1 1 1 4 4 1 4 4 1 4 1 1 1 1 1 1 1 1 1 1 1 1 1 1 1 1 1 1 1 1 1 1 0
0 1 3 1 1 1 1 1 1 1 1 1 1 1 1 3 1 1 4 4 4 4 4 4 4 4 4 4 1 1 1 1 1 1 1 1 1 1 1 1 1 1 1 1 1 1 1 1 1 0
3 3 3 3 3 3 3 3 3 3 3 3 3 3 3 3 1 1 4 4 4 4 4 4 4 4 4 4 4 1 1 1 4 1 1 1 1 1 1 1 1 1 1 1 1 1 1 1 1 0
0 1 1 4 1 1 1 1 1 1 3 1 1 1 1 3 1 1 4 4 4 4 4 4 4 4 4 4 1 1 1 1 1 1 1 1 1 1 1 1 1 1 1 1 1 1 1 1 1 0
0 1 1 1 1 1 1 1 1 1 3 1 4 4 1 3 1 1 1 1 1 1 1 1 1 4 1 1 1 1 1 1 1 1 1 1 1 1 1 1 1 1 1 1 1 1 1 1 1 0
0 1 1 1 1 1 4 1 1 1 3 1 4 4 1 3 1 1 1 1 1 1 3 3 3 3 3 3 3 3 3 3 3 3 3 3 3 3 1 1 1 1 1 1 1 1 1 1 1 0
0 1 1 1 1 1 1 1 1 4 3 1 4 4 1 3 3 3 3 3 3 3 3 3 3 3 3 1 1 1 1 1 1 1 1 1 1 3 1 1 4 4 4 1 1 1 1 1 1 0
0 1 1 1 1 1 1 1 1 1 3 1 4 4 1 1 1 1 1 1 1 1 3 3 3 3 3 1 1 4 1 1 1 1 1 1 1 3 1 4 4 4 4 4 1 1 1 1 1 0
0 1 1 1 1 1 1 1 1 1 3 1 4 4 4 4 4 4 4 4 4 1 1 1 1 1 1 1 4 4 4 1 1 1 1 1 1 3 1 4 4 4 4 4 1 1 1 1 1 0
0 1 1 1 1 1 1 1 1 1 3 1 4 4 4 4 4 4 4 4 4 4 4 4 4 4 4 4 4 4 4 1 1 1 1 1 1 3 1 4 4 4 4 4 1 1 1 1 1 0
0 1 1 1 1 1 1 1 1 1 3 1 4 4 4 4 4 4 4 4 4 1 1 1 4 4 4 4 4 4 4 1 1 1 1 1 1 3 1 1 4 4 4 1 1 1 1 1 1 0
0 1 1 1 1 1 1 1 1 4 3 1 4 4 4 4 4 4 4 4 1 1 1 1 1 4 4 4 4 4 4 1 1 1 1 1 1 3 1 1 1 1 1 1 1 1 1 1 1 0
0 1 1 1 1 1 1 1 4 4 3 1 4 4 4 4 4 4 4 4 4 1 1 1 4 4 4 4 4 4 4 1 1 1 1 1 1 3 1 1 1 1 1 1 1 1 1 1 1 0
0 1 1 1 1 1 1 1 1 4 3 1 1 4 4 4 4 4 4 4 4 4 1 4 4 4 4 4 4 4 1 1 1 1 1 1 1 3 1 0 0 0 0 0 0 0 0 1 1 0
0 1 1 1 1 1 1 1 1 1 3 1 1 1 1 4 4 4 4 4 4 4 1 4 4 4 4 4 4 1 1 1 1 1 1 1 1 3 1 0 3 3 3 3 3 3 0 1 1 0
0 1 1 1 1 4 1 1 1 1 3 1 1 1 1 1 1 4 4 4 4 4 1 4 4 4 4 4 1 1 1 1 1 1 1 1 1 3 1 0 3 3 3 3 3 3 0 1 1 0
0 1 1 1 1 1 3 3 3 3 3 3 3 3 1 1 1 1 1 1 1 1 1 1 1 1 1 1 1 1 1 1 1 4 1 1 1 3 1 0 0 0 3 3 0 0 0 1 1 0
0 1 1 1 1 1 3 3 3 3 3 3 3 3 1 4 1 1 1 1 1 1 1 1 1 1 1 1 1 1 1 1 1 1 1 1 1 3 1 1 1 0 3 3 0 1 1 1 1 0
0 1 1 1 1 4 3 3 3 3 3 3 3 3 1 1 1 1 1 1 1 1 1 1 1 1 1 1 1 1 1 1 1 1 1 1 1 3 3 3 3 3 3 3 3 3 3 3 3 3
0 1 1 1 1 1 3 3 3 3 3 3 3 3 1 1 1 1 1 1 1 1 1 1 1 1 1 1 1 1 4 1 1 1 1 1 1 3 1 1 1 1 1 1 1 1 1 1 1 0
0 1 1 1 1 1 3 3 3 3 3 3 3 3 1 1 1 1 1 1 1 4 4 4 1 1 1 1 1 1 1 1 1 1 1 1 1 3 1 1 1 1 1 1 1 1 1 1 1 0
0 1 1 1 1 4 3 3 3 3 3 3 3 3 4 1 1 1 1 1 1 1 4 1 1 1 1 1 1 1 1 1 1 1 1 1 1 3 1 1 1 1 1 1 1 1 1 1 1 0
0 1 1 1 1 1 3 3 3 3 3 3 3 3 1 1 1 1 1 1 1 1 1 1 1 1 1 1 1 1 1 1 1 1 1 1 1 3 1 1 1 1 1 1 1 1 1 1 1 0
0 1 1 1 1 1 3 3 3 3 3 3 3 3 1 1 4 1 1 1 1 1 1 1 1 1 1 1 1 1 1 1 1 1 1 1 1 3 1 1 1 1 1 1 4 1 1 1 1 0
0 1 1 1 1 1 3 3 3 3 3 3 3 3 1 1 1 1 1 1 1 1 1 1 1 1 1 1 1 1 1 1 1 1 1 1 1 3 1 1 1 1 1 1 1 1 1 1 1 0
0 1 1 0 0 0 0 0 0 0 0 0 1 3 4 1 1 1 1 1 1 4 1 1 1 1 1 1 1 1 1 1 1 1 1 1 1 3 1 1 1 1 1 1 1 1 1 1 1 0
0 1 1 0 1 1 1 1 1 1 1 0 1 3 1 1 1 1 1 1 1 1 1 1 1 1 6 1 1 6 1 1 1 1 1 1 1 3 1 1 1 1 1 4 1 1 1 1 1 0
0 1 1 0 1 0 0 0 0 0 1 0 1 3 1 1 4 1 1 1 6 5 5 5 5 5 5 5 5 5 5 6 1 1 1 1 1 3 1 1 1 1 4 1 1 1 1 1 1 0
0 1 1 0 1 0 1 1 1 0 1 0 1 3 1 1 1 1 1 1 5 5 5 5 5 5 5 5 5 5 5 5 1 1 1 1 1 3 1 1 1 1 4 1 1 1 1 1 1 0
0 1 1 0 1 0 1 0 1 0 1 0 3 3 3 3 3 3 3 3 5 5 5 5 5 5 5 5 5 5 5 5 3 3 3 3 3 3 1 1 1 1 1 1 1 1 1 1 1 0
0 1 1 0 1 0 0 0 1 0 1 0 1 1 1 1 1 1 1 1 6 5 5 5 5 5 5 5 5 5 5 6 1 1 1 1 1 1 1 1 1 1 1 1 1 1 1 1 1 0
0 1 1 0 1 1 1 1 1 0 1 0 1 1 4 0 1 0 1 1 1 1 1 6 1 1 6 1 1 6 1 1 1 1 1 1 1 1 4 1 1 1 1 1 1 1 1 1 1 0
0 1 1 0 0 0 0 0 0 0 1 0 0 0 0 0 1 0 1 1 1 1 1 1 1 1 1 1 1 1 1 1 1 1 1 1 1 1 1 1 1 1 1 1 1 4 1 1 1 0
0 1 1 1 1 1 1 1 1 0 1 1 1 1 1 1 1 0 1 1 1 1 1 1 1 1 1 1 1 1 1 1 1 4 1 1 1 1 1 1 1 1 1 1 1 1 1 1 1 0
0 0 0 0 0 0 0 0 0 0 0 0 0 0 0 0 0 0 0 0 0 0 0 0 0 0 0 0 0 0 0 0 0 0 0 0 0 0 0 0 0 0 0 0 0 0 0 0 0 0